
NO ./textures/north.xpm
SO ./textures/south.xpm
WE ./textures/west.xpm
EA ./textures/east.xpm

C 255,55,0   
F 254,244,25


11111111111
10000001111
11110000001
11100001001
111100N0011
111100000011
111111111111111
