
NO ./textures/north.xpm
SO ./textures/south.xpm
WE ./textures/west.xpm
EA   ./textures/east.xpm


C 225,30,0    
F 220,100,0

11111111
10000001
10000001
10001001
10000N01
11111111
