
NO ./textures/north.xpm
SO ./textures/south.xpm
WE ./textures/west.xpm
EA ./textures/east.xpm 

C 255,55,0   
F 254,244,255

111111111111111
100000011111111
111000000000001
111000000000001
111100000N00001
111100000000011
111111111111111
