
NO ./textures/north.xpm
SO ./textures/south.xpm
WE ./textures/west.xpm
EA ./textures/east.xpm 

C 255,55,0   
F 254,244,255

11111111
10000101
10100001
1000N001
10000001
10100001
10001001
11111111
