
NO ./textures/north.xpm
SO ./textures/south.xpm
WE ./textures/west.xpm
EA ./textures/east.xpm 

C 135,206,250
F 255,200,155

11111111
10000101
10000101
1000N001
10000001
10000001
10000001
11111111
