
NO ./textures/north.xpm
SO ./textures/south.xpm
WE ./textures/west.xpm
EA ./textures/east.xpm

C 255,55,0   
F 254,244,25


11111111111
10000001111
11110000001
11100001001
11110000N01
11111111111