
NO ./textures/north.xpm
SO ./textures/south.xpm
WE ./textures/west.xpm
EA ./textures/east.xpm

C 255,55,0   
F 254,244,25


11111111111
11111111111
10000001111
11110000001
   10001001
11110000N01
11111111111
