NO ./textures/north.xpm
SO ./textures/south.xpm
WE ./textures/west.xpm
EA ./textures/east.xpm 

F 135,206,250
C 255,200,155

11111111111111111111111111
10000000000000000000000001
10010000000000000000001001
10000000000000000000000001
10000011111000111110000001
10000000000111000000000001
100000000001S1000000000001
10000000000101000000000001
10000001000000000100000001
10000001111111111100000001
10000000000000000000000001
10000000000000000000000001
10001100000000000000110001
10001100000000000000110001
10000000000000000000000001
11111111111111111111111111
